respeaker	R IY S P IY K ER
hi	HH AY
hey	HH EY
hello	HH AH L OW
hello(2)	HH EH L OW
mr	M IH S T ER
miss	M IH S
lady	L EY D IY
lisa	L IY S AH
coco	K OW K OW
alexa	AH L EH K S AH
robot	R OW B AA T
play	P L EY
stop	S T AA P
pause	P AO Z
mute	M Y UW T
increase	IH N K R IY S
decrease	D IH K R IY S
turn	T ER N
on	AA N
on(2)	AO N
off	AO F
volume	V AA L Y UW M
music	M Y UW Z IH K
light	L AY T
what's	W AH T S
what's(2)	HH W AH T S
your	Y AO R
your(2)	Y UH R
name	N EY M
